AEEEEEEEEEEEEB
F            F
F            F
F            F
F            F
CEEB  AEEEEEED
   F  F
   CEED