AEEEEEEEEB
F        F
F        F
F        F
F        F
CEEB  AEED
   F  F