    AEEEEEEEEEEEEEEEB
    F               F
    F         F     F
    F         F     F
              F     F
    F         F     F
    F         F     F
    F         F     F
    F         F     F
    F               F
    CEEB  AEEEEEEEEED
       F  F
    AEED  CEEEEEEEEEB
    F               F
    F         F     F
    F         F     F
    F         F     F
    F         F     F
    F         F     F
    F         F     F
    F               F
    F               F
    CEEB  AEEEEEEEEED
       F  F
       CEED